

NO ../tilesets/cub3d_new_pngs/north.png


SO ../tilesets/cub3d_new_pngs/south.png
WE ../tilesets/cub3d_new_pngs/west.png


EA ../tilesets/cub3d_new_pngs/east.png
F 255,100,255

C 155,30,255






 111111101111111
10000000000000001
10000000000000001
10000000N00000001
10000000000000001
10000000000000001
 111111111111111