

NO /home/akuburas/cub3d/tilesets/cub3d_new_pngs/north.png


SO /home/akuburas/cub3d/tilesets/cub3d_new_pngs/south.png
WE /home/akuburas/cub3d/tilesets/cub3d_new_pngs/west.png


EA /home/akuburas/cub3d/tilesets/cub3d_new_pngs/east.png
F 255,204,10

C 150,150,150






1111111111111111111111
1000000000000000000001
1000000111111100000001
1000000100000010100001
10000001000S0000000001
10000000000000000000011111111111
100000011111111111100000000001001
10000000000000000010011111111111
1111111111111111111111