

NO /home/akuburas/armin_zone/school_projects/cub3d_zone/github_repo/first_attempt/source_files/tile007.png


SO /home/akuburas/armin_zone/school_projects/cub3d_zone/github_repo/tilesets/dark_level_2/tile007.png
WE /home/akuburas/armin_zone/school_projects/cub3d_zone/github_repo/tilesets/dark_level_4/tile007.png


EA /home/akuburas/armin_zone/school_projects/cub3d_zone/github_repo/tilesets/dark_level_4/tile022.png
F 255,100,255

C 255,30,000255






1111111111111111111111
1000000000000000000001
1000000111111100000001
1000000100000010100001
10000001000N0000000001
1000000000000000000001
1000000000000000001001
1000000000000000001001
1111111111111111111111