

NO /home/akuburas/cub3d/first_attempt/source_files/tile007.png


SO /home/akuburas/cub3d/first_attempt/source_files/tile007.png
WE /home/akuburas/cub3d/first_attempt/source_files/tile007.png


EA /home/akuburas/cub3d/first_attempt/source_files/tile007.png
F 255,100,255

C 255,30,000255






         11111111111111111111111
        1000000000110000000000001
        1111000001110000000000001
        1001000000000000000000001
111111111011000001110000000000001111
100000000011000001110111111111111
11110111111111011100000010001
1111011111111011101010010001111111111
1100000011010101110000001000000000001
1000000000000000110000001000111111111
10000000000000001101010010001
11000001110101011111011110N0111
11110111 1110101 101111010000001
10000000100000001000000000000001
11111111 1111111 111111111111111