

NO /home/akuburas/cub3d/tilesets/cub3d_new_pngs/north.png


SO /home/akuburas/cub3d/tilesets/cub3d_new_pngs/south.png
WE /home/akuburas/cub3d/tilesets/cub3d_new_pngs/west.png


EA /home/akuburas/cub3d/tilesets/cub3d_new_pngs/east.png
F 255,204,10

C 150,150,150






1111111111111111111111
1000000000000000000001
1000000111111100000001
1000000100000010100001
10000001000W0000000001
1000000000000000000001
1000000000000000001001
1000000000000000001001
1111111111111111111111