

NO /home/akovalev/Desktop/42/ak-cub3d/first_attempt/source_files/tile007.png


SO /home/akovalev/Desktop/42/ak-cub3d/tilesets/dark_level_2/tile007.png
WE /home/akovalev/Desktop/42/ak-cub3d/tilesets/dark_level_4/tile007.png


EA /home/akovalev/Desktop/42/ak-cub3d/tilesets/dark_level_4/tile022.png
F 255,100,255

C 155,30,000255






1111111111111111111111
1000000000000000000001
1000000111011100000001
1000000011111110100001
10000001101S0000000001
1000000000111010000001
1000000000000000001001
1000000000000000001001
1111111111111111111111